13 28
S.........G...GG...G..G.....
.XXXXXX.X.XXXXXXXXXXXXXXXXX.
.X....X.X......G...G...G....
.X.XX.X.X.XXXX.XXXXXXXXXXX.G
.X..X.X.X...X.X.G....G..G...
.X..X.X.XXX.X.X.XXXXXXXXXX..
.X.KX.X...X.X.XKXTG...G..G.G
.XXXX.XXX.X.X.X.X.XXXXXXXX..
...GGG....X.X.X.X..GG.......
.XXXXXXXX.X.X.X.X.XXXXXXXX..
.....G....X.X.X.X...........
.XXXX.XXX.X.X.X.X.XXXXXXX.X.
.X..X.....X.X.X.XGGGGGGGGGGG