13 28
S...........................
.XXXXXX.X.XXXXXXXXXXXXXXXXX.
.X....X.X...................
.X.XX.X.X.XXXXXXXXXX.XXXXX..
.X..X.X.X...X...............
.X..X.X.XXX.X.X.XXXXXXXXXX..
.X.KX.X...X.X.XKXT..........
.XXXX.XXX.X.X.X.X.XXXXXXXX..
..........X.X.X.X...........
.XXXXXXXX.X.X.X.X.XXXXXXXX..
....G.....X.X.X.X...........
.XXXX.XXX.X.X.X.X.XXXXXXX.X.
.X..X.....X...X.X...........