10 10
XXXXXXXXXT
XX...XX..K
X.........
XXXXXXX...
....XG....
XX..XGX...
....XXX...
XX...XX.K.
S.........
XX...XX...