10 10
.G.......T
XX...XX..K
X.........
XXXXXXX...
....X.....
XX..X.X...
....XXX...
XX...XX.K.
S.........
XXXXXXXXXX