10 10
.........T
XX...XX..K
X.........
XXXXXXX...
....XG....
XX..XGX...
....XXX...
XX...XX.K.
S.........
GGGGGGGGGG