10 10
.........T
XX...XX..K
X..G......
XXXXXXX...
....X.....
XX..X.X...
....XXX..S
XX...XX.K.
..........
KKKKKKKKKK